0001111110000000000000000000000
0000111111000000000000000000000
0000001111110000000000000000000
0000000011111100000000000000000
0000001111110000000000000000000
0000111111000000000000000000000
0000001111110000000000000000000
0000000001111110000000000000000
0000000000001111110000000000000
0000000000111111000000000000000
0000000011111100000000000000000
0000001111110000000000000000000
0000111111000000000000000000000
0000001111110000000000000000000
0000000011111100000000000000000
0000001111110000000000000000000
0000111111000000000000000000000
0001111110000000000000000000000
0001111110000000000000000000000
0000111111000000000000000000000
0000001111110000000000000000000
0000000011111100000000000000000
0000001111110000000000000000000
0000111111000000000000000000000
0000001111110000000000000000000
0000000001111110000000000000000
2222222233333322222222222222222
2222222233333322222222222222222
2222222233333322222222222222222
0000001111110000000000000000000
0000111111000000000000000000000
0000001111110000000000000000000
0000000011111100000000000000000
0000001111110000000000000000000
0000111111000000000000000000000
0001111110000000000000000000000
0001111110000000000000000000000
0000111111000000000000000000000
0000001111110000000000000000000
0000000011111100000000000000000
0000001111110000000000000000000
0000111111000000000000000000000
0000001111110000000000000000000
0000000001111110000000000000000
0000000000001111110000000000000
0000000000011111100000000000000
0000000011111100000000000000000
0000001111110000000000000000000
0000111111000000000000000000000
0000001111110000000000000000000
0000000011111100000000000000000
0000001111110000000000000000000
0000111111000000000000000000000
0001111110000000000000000000000
0000001111110000000000000000000
0000000011111100000000000000000
0000001111110000000000000000000
0000111111000000000000000000000
0001111110000000000000000000000



